16.12
1111111111111111
1000000000000001
1000000000000002
1020000000000002
1000000000001002
1000000000000002
1000000000000002
1000000000000002
3000000000000002
3000000000000002
3000000000000002
1111111111111111